aerosol	liquid sprayed in the air in a fine mist
antagonist	person or thing working against the protagonist or hero in a story
aqueduct	a channel to carry water for drinking and irrigation
asynchronous	(not) having a meeting time together
beneficiary	person who receives something good from someone else; ex. inheritance
bilingual	able to speak 2 languages
centennial	happening once every 100 years; 100th anniversary
citizenship	the rules and privileges concerning a person who lives in a specific city.
cryptic	something with a secret meaning; something mysterious
decimate	to cause severe harm or damage; to destroy at least 1/10 of something
decline	to go down; to droop; to slope downward
dismal	negative; causing bad feelings; causing gloom and misery
equity	being fair, just, and equal in dealing with others
hypercritical	extremely or excessively critical
inaudible	not able to be heard; not loud enough to hear
malicious	doing something bad to someone else; doing bad/wrong actions on purpose
manufacture	to make something from raw material by hand or machine
monotonous	the same one thing over and over; no variety; voice with only 1 tone
pedestrian	a person who walks on a street on foot
percent	the number of parts in 100; per 100
pessimist	someone who sees things or puts things in a negative way; opposite of optimist
polychromatic	having many different colors
prejudice	prevent negatively judge someone or something before having the facts
reiterate	to say or do something again
subterranean	underground; under the earth's surface
unkempt	not maintained or cared for; neglected; disheveled, ignored
unruly	not following the rules; disobedient; misbehaving
xenophobia	abnormal fear or dislike of strangers or people from foreign lands
